##^################################################ ################################################### #############################
##^#### # # # ## ## ## # # ## ## # ## # # # ## # # ## # # # # ## # # # ## ## # # # # ## # # # ## ## # # # ## # #
#*++## # ## ## # ## # # ## ## ## ### # ## ## ### ### ## # ### ## # ### # # # # # ### # ###
###+ ## # # #### ## ## ## # ## # ## # ## ###### # ## ##### ### ## ## # # # ## ### ### ## # # ##### # # # ## # #
# #+## # ## ## ## ## # ### ## ## # ## # #### # #### ##### # # ## ### # ## # # # ### # ## # # # ### # #
# #+### ## ####### # # #### ## # # ### ## ## # ## # # ## # ###### # # # # ####### ## # #### # #
# ++ ## # # ## ## ## ######## # # ## # # ########## ### #### # # # # # # ###### ## ### ###### ######### ### #
##+####### ## ## ## ## # ##### # ## # ##### ## # # #### # ## ## ## ## ## ## # ## ###### # ### # ### ## #
# +# # # # #### ## ## ## # ### # #### ## # ## ## ## # # ## ###### # ##### # ### # # # ### ### ##### #
##++++ # # #### ## # ###### ## ## ### ## ## # # ### ## # ####### ## # # # # ### # # ######## ####
#####+## # ###### # ## ## ## ### ##### ## ## ###### ### # ## # ### ## ## # ### # # #### #### # ##### ## # ### ##
# + ## ## # ### # ## # # ## ## ### # ## #### ##### # # ###### ## ## # ### #### # ## # ## ##### #
#####+######### ##### # # ## ## ## # # # ## ## # ## ###### # ### ## #### ## ## # ## ### ####### ### ##
# # ++### # ##### # ##### ## # ## ## ## ## ## ## ### ## # ## ## ## ## ## ## #### ## ### ## # ## # # #
## ###+ # # ### #### # #### # # # #### # ### # ## ### # # #### ## ##### # ## ## ## ## ## ## ### # # ##
## # #+### # # ## ## #### ## ##### # ## ## ### # ## ## ## ### ### ## ## # # # # #### ## # # # #### ## #
# +## ## ### ### ### # # ## # #### ## # # # ## #### ### # # ### ## # # ### ## ## ######### ## ## # # ##
######+ ### ## ## # ## # ## ## # # ## ## # ## # ### ### # # # ## ### #### #### # ## #### ### ## # # ## ######
# ### +## #### ## ### # ## ## # ## ### ###### # ## ## ## ## # # # ## # ## # # ## # # ## # ## #### ### #
# ##+ ## ## ## ## ## ##### ## # #### ## # ## # ## # ## # # ## # # ## ##### ## ## ## ## # # ## ## ### ## # #
# # #+## ##### # ## # ## ## # ## ## # ## ##### #### ## # ## ## # # ## # ## # ## ## # # ## # ##
#### ++ # # ## ## ## ## #### ## # ## ## # ## ### #### ######## ## # ## # # # #### #### ###### ## #
#####+###### ## #### # ## ## # ### ### ### # #### ## # ### ## ## ## ### ## # # ### ### ###### ######## ###
# # ++# #### # ## ## ####### ## ## # ## #### # # # ## #### # ## # # ## ## # ## # ## #### ### # ###
# ####++ ## ## ### # ## # ###### ### # # # ### #### # ###### ## #### # # ###### # # # # # ## # ## # ### #
# ####+#### #### ##### #### #### #### # ## ## #### # ##### #### ## # # ### #### # ## # ## ## # ## # # #
# ## # ++## # ## # #### ## # # ### # ### # ## ## ##### ##### ## ## # # ## ### ## ## # # ### ## ### # #
# # ###+ ## # # # # # ## ## ### ### # # #### # ## # # # # # # ## # ## ### # ## # ### #### # #### # ##### ## #
# ####+## ##### # #### #### # ## # ## # ## ## ### # # ## ## ## ### # ## # ## # # ## ## ###
### ## #+###### ## ## #### ### ### ### ## # #### # # ##### ## ## ## ########### # # #### # # # ##### ## #
# # ## ++# ## # ## # #### ##### # # ### ## ## ## ## ## # # # ## ## #### ## #### ## # ### ###
# # ##+## # # ## ## ## ## # # ##### ### ## ## ######### ### # # #### # #### #### ############ # # # # ## # # # #
# ## +++ ##### # # # # ## ## ## # # ## ## # ### ## # ######## ##### # ## ## # # ###### # # ###### # # #
# #######+### ## ## # ## # #### ## # ######## ## # # ## ## ## # # # ## ## ## # ## ## ## # ## # # #
# # ## #+## # # # ## # ## ### ## # #### # ### ## ### # ## ## #### # ## ### ### ### # ## # #########
# ## #+### ## ## # ## ####### # # # # # ## # ######### ############ ## # ### ## ## ##### ## ### ###
### ### ++# # #### # # ## # ## ######## ## ## ## # #### # ### ## ### # # #### # # ## # # ## ## ##### #
### ## ##+### ### ### # # # # #### ### ##### ## ## ### ## # # # ## # ## ## ### ## ## ##### ### # #
# #####+## # # #### #### # # # ### # # ## ## ## ## ## ## # ## # ## ### ## ### # ### #### ## # ### #
### ## # #++## # ## ####### ## ### # # # # ########## ### # # ## ### # ## # #### ## ### # # # ### # # ##### #### #
# # ##+## ## ## ### # ## ## # # ## ## ## ## ### # ###### ## ### # ## ## # ## # # # ## # # # ## #
###### # # ++# ### # ## #### ## # # # ## # ### ## ## # ## ### # # ### ## # # ### # ### ## # ## # ## ### ## #
# # ###+# ## ## # ### ## ### ## #### # ## ## ## #### #### ## # ###### # # # # # ## ## # ######### ##### ## #
#### # ### +# ### ### # ## ### ## # #### # ## ## ## # ## # # ### # ### ## ## # # # # ### # ## # ## ## #
# # # ###+# # ## ### # ## ## ## ## ## # ##### # ## ## # # ## # # # # # # ## # # # # # # ### ##### ##### #
# ## # ##+# # # ### # ## ### ## ## # ## ### ### ## # # ### # # # ####### # # ## ###### ## #
# ##### # +# # # ### ##### ## ## ## ### ### ### ### ###### ## #### # # ####### ## ## # # # ########### ## ##### ## #
# #######+# ## # ## ## ## # # ## # # ## ## ## ## ### # # ## ## # # # # ### # #### # ## ### #
### ## # ## ++ ## #### # # #### ## ### # # ### ##### ## ## # ## ### ## # # ## ### # #### ## ## ## # #
# ## # ####+### # ########### # ## ## ### # ### #### # ## # ## ### # ## # ## ## # ## ## # ######
### ## # # #++# ### ## ## ## # # ##### ## ## ##### ### # # # ## # ##### #### ### ### ## ## # # ######### #
# # # # ++## ## # ## # # ## ## ## # # # # ## # # #### ### # ## # ## # ## ##### ##### ## # ##### #######
# # #### ##+### ### # ### ## # ####### # ## ### # # # # # ## ## ## # ## # # ### # ## ## ## ## #
# # +## # ## # # # # # # ## # #### ####### # # # ## # ###### # ## ####### ## ## ## # # # ## # # # # #
# #########++## # # # ## ## ## # ## ## ### # # # ### ## ## # # ### # ### ###### ####### ##### ### ####### #
# ## # ## ##+## # ## ##### ## ## ## # #### ## # ## ######### # # ## ## ## # ## # ### # # ### # # # ## ## ## ####
# # # ## ##+## # # ## # ### ## ## # ### #### ## ## # ###### ## ## # ## # # # ### # # ##### ## ### # ##
# ## # # ##+## # ## ## # ## ### # #### # # # # ### #### ## ### ### ## # ## # # # # ## ## ## ## #
# ## # +## ### ## ### # ##### # ## ## # ##### # ### # ### ## ##### # # # # ####### # #### ## ### #
#### # # ##++++# # ## # ## #### ### ## ### ### # # # # # ## ## #### ### #### # ### # ## # ## ### # # ### ## #
# #### # ######+ ## ##### # ## ####### ##### ## ## ## # # # ### ## # # # ### # ## # # ## # # ## # ### #
# # # # ## ##+######### # # # ## # ######### ## # # # # # ## ## ## # ### #### ### #### # # ## ## # #
# # ## # ## +### # ## #### ####### ### ### ## ## # ## ### # # # ##### # # ## ###### # # # ##### # ##### # #
# # # ######+++# ## # # ### ## # # #### ## # # ## ### # # ##### # # ## ## # ## # ### #### # ### # # # # ##
### ## # ## ###+# ###### # ## # ## # ## # ## # ## ### ## ## ## ### # # # # #### #### # ######
# # # #### ###+# # ## ### # # ### ##### # ## #### ## # #### ##### ## # # # ## ## ### ####### # # ## ## # # # #
## # ## #+++# # ###### ## # ## ## ## # ### ## # # # # ##### ### ## ## ## ## ### # ## # ## # ##### # #
######## #### #+### # # # ### ### # ## #### ### # ### # # # ### # # ## ## ### # #### # # ## ##### #
# # # ## ## # #+## # ## ### ##### ## ## ## ## ## # ### ## ## ##### # # # # ### ## #### ####### # ## ##
# # # # ## # + ## # # # ## # ### ###### #### ### #### ### # # ## # # # # # ## ### # #### ## ## # ### ## ## #
# # ## ###+#### # # # # ## ### ## ### ## # ## ### # # # ## ### ## ### # ## # ##### # # ### ## ###
##### # ## ## + ## ### # # ## ## ### ##### #### ### # # ## # ## ## # ## # # ## # ### #### # ## # # ## #
# # # # ### ###+#### ## # ## ### # # ## ## #### # #### ## # ### # # # ### # ### ## ### ## # ### ##### ####### ###
# # # ##+# ### ## ## ## # # # ### #### ## # ## ##### ## # ## # ##### ## # # ## # ## ## ## ## # # ##
# ###### ### +++++## # # ## ### # # # #### # #### # ## ## # # ### # # ## ######### ## # ### # #### # # ## #
# # # # # ##### #+## # # ## ## # ## ### # # # ## ### # # # #### ## #### ### # ### # ## ## # ## # # ## # ##
# # ##### # ####+### #### # ### ## #### ## ## # # # # # # # # # # #### # # # ## ### ## # ### ## ##
# # #### ## # # + ## ## ## # #### ## ####### ## # # # # # # # ### ## ## ### # # ## ###### ###### ##### #
# # # #### ## # ##+#### ## ##### ### ###### # ## # # # # # # # ## ## ### # ## ###### ### ###### # ## ### #
# # ## # # ##+ ## # ## # ##### ## #### ##### # # # # # # ##### # # # ##### ## # # # # # # ##### #####
# # ## # #### #####+#### ## ## # ###### #### ### # # ### # # # ## ### ## #### #### # ### ### #### ### ## #
# # # # ### # ## + ## ## # ####### ## # # # ## ## ## # # # ### #### ## ### # ### # # ##### ## #####
# # ## # # ## ##+#### ###### # ## # ## ## # ##### ## # # #### # ## # ### ### #### # # ## # # ##### # ### # # #
# ## # ##### ##+# # # ## ## # ###### ## ## ## # # #### # # # # # ### # # ## # # # # # # ## ###
### #### # # # #+# # # # ## #### # # ## ######### #### # ### #### # ## # # # ## ### # ## #### # # # ### ##
# ## # # #### +++# ### # ## # ## # ### ## ## ## # ## ## ### #### ### ### ### # # ###### ## # # ### #
#### ### # # # ## ###+# ### # ## ## # ##### ###### # #### ## ### ### # #### ## # # # # # # ## # ##### # ### ##
# # # ## ## +# ## # ### ### # ## ## # # # # ## ## ## # ### # ## ## ## # ### # # ## ## ## # ## # #
# # #### # ########+# # # # ## ## ## # # # # # # # # ##### ##### ## #### ### ### ## ## # ## # ## ### ## ###
###### ### ## # #++ # ####### #### ## # ## ### ## # ###### ## ### # ## # ## ## ##### ### ## ## # # # #
# # ## ### ## ++# #### # # # # ## # ###### # ## ### # # # # #### ## ## ### #### ## # # ## # #### # # ## ## #
## ### ### ## ##+####### # ## ### ### ## ### # # # ### # ## # ## #### #### #### ## # ##### ###
# # ### ## + ## # # #### ##### # ## ## ## # ## # # #### ## ## ####### ## ## # ######## ## ## ## #
## ####### # ## ##+### ## ## #### # ## ## ## ### ##### # ### ## ## # # ##### ## # # # ## # # ##### ### # ##
# ## # # ## ## ++ ### # ## # ## # ## ## # # #### # ### ## ## ###### # ### # ### ## ### ## ## ####
# # ## ## # ## ## #+## # # ### ## # ####### ###### ## ## ######## ## # ## # ### ## ## # ### ## ## # ## # #
### ## ## ####+ # # # ## ## ##### # ## # # ## # # ### ### ######## # # # ## ### ### ####### # ### ## #
## #### ### # ## +## # # ####### ## ## #### ## ## # #### # # ### # ## # # ### ## ## ## # ### ## # #
# ## ### # # #####+## # # # ## ###### ### #### ## ## ## ## ## # ## ### ## ## #### ##### ## # #### ## ### #
## ## ## # ## #+ ## ##### # ## ## ## # ## ## ### ####### ## # # # ## # # # ## ## # # ## ### ## # ### ## #
### # ## ### ## #+## # ## ## #### # ## #### # #### ### # ## # # ##### # ### ## # ### ## # # ## #### #
# ## # ## ### ### #+ # ######## ## # # # # ## ## ## # ###### # ## # #### ### ## # # # ## #### # # # # ## #
# # ### ## #+## ## ##### ## ## # ## # ### ## # # ## #### ## # ### # ## ## #### ## ### # ## # ## # ## ## #
#### # # ###### # #+## ### ## ## # # ## ## ### # ## ### ### # ### # ## # ### # # # # # ## # # ### ### ##
# # # ##++++++ # # # ##### ## ## #### ### # # ### ##### # ######## ## # ## # ### ## ## ###### ##
######## # ## # +### ## # # # ## ### # # # ## # # # #### # ## ## # ## ## ## ###### ####### # # ### ## ## #
# # # ## ##+####### ## ## ## # ## # ## # ## # ## # # # # ###### ###### # ## ## ## # ###### ## ## ### #
### ## ## ## #+ ## ## # ## ## ## ## ### ## ## ### # ## # ### # ## #### ## ## ### ###### ## # ## ### ### ## #
# # ###+++# ## # ## ### # ## # # ##### # ## # # # ## ## #### ## ## # ## ## ## # ## # ### #
### # ### ## +### # ## ## # ####### #### ## # ## # ### #### ## # # ## # ######### ## ## # ## # # # #
## # ## ####++#### ###### ####### ### # # ## # ## # ####### # # # # ## # ## ######## ## ## ## # #### #### # # #
# ###### ###++## # ## ###### # # ###### # ### # # ## # ### ### ## # # ## ## # ## ## ## # # ### ## # #
## # # ### # ##++## ## ## ## # # # ## ## # # ## ##### #### # ## ## ## # # # ### ###### ##### # ## # # ## ## ### #
# ## ### ##++# # # ## ### ## ##### # # ## # # ## #### # # # # ## # #### ## ## ## # # ## # # #
#### ## # ### ####+ ## ## ####### # # ## ### ### ## ## ### ## # ## # # ## ##### # # ## ## # ## ######## # #
### ## # ## ## #+# # # # # ### # ## # # # #### #### ## ## ## ## ##### ## # ########### ### ## ## # ## # ####
# ## # ## +##### ## ## ## # # # ## # ### ## ## ## # ## # ### # ## ## # ## ## ######### #### ##
# # #### ########+ ## ######### ####### # # ## #### ## ## ## ## # ### ## ## ## # ###### ## # # # # ## ## #
## # ## ## ##+#### ## ## ## #### ### # ## # ## ## ## ### ## # # # ## # ## ## # # ## ###### #
# #### ### ###++ ## ## #### ### ## # ## ###### # ###### # ### #### #### ## # # #### ## # ## # #### # ### ### # #
#### ## ## ## +##### # # # # # # # ## ### # ## # # # ## # ## # # ### ###### ###### ###### ## # # ## # #
# ### ### ## ##+## # ## ## ## ## # # ### ## ## # # ### ##### ## # #### # ## ####### # # ## # # # # ##### #
# # ## ## ## + ## # # ##### ###### ## ## ## # ### ## # ## # ## # # ## ## # # ## # ## ## ###
# ### ### # ####+## # ## #### ## # ###### ## ## ### # ### ## ## # ### # #### ######## #### # ## # ## # # #
# # # # # ## ## ++## # # ## ## # # ## # # ## # ## # ## ### ### ### ## ##### # ###### # # # ## #### ## # #
# # # #####++++# ## # ### ## ### # # ## ## ## #### ##### # ## ## # ### # # # # ## ## # ## ## # ## # #
####### # ## #####+# # # ### # ## # ### ## # # ## ### ###### ### ### ## # # ## ## ### #### ## # #
### # #### ##+# ######## # ## ## # ####### ###### ###### # # # ## # ## ### ## # ## ## ## # ######## ###
# ## ##### # ## ##+# # # # ## ###### ## ### ## # ## ## ## # ## # ###### #### # ### ## ## ### # #### ## ## #
### #### # # ## # # +# ##### ## # ## ## # # ##### ## # ### ## # ### # ### # ## # # ### ## # # # ## # # ####
# ## ## ##+ ## ## # ## ## ## # ## ## ## ## # ## ## ## ### # ## # # ## # #### #### ## #
#### ######### # ##+####### ###### ### ## # # ##### ### ##### #### ##### ### ######## # # ### # ## ## # ####
# ### ## #++ # ## # ## ## #### ## ## # ## # # ## # ## ## # # # ###### # ## # ## ### #### #
# ## ## ##### ## ++# # # ## ## # ###### ###### ## #### # # ##### ### ###### # # # # # ###### # ####### # ######
# # # #### # ##+####### # ## ## # ## ## ## # # #### ### # ## # # ## # # # # ##### ## ## # #
#### # # # ## #+ # ## # ## ## #### ### # ######### ## # ## ######### # # # ## ### ### ## ## ## # ##
###### # ######## #+### ## ## ###### ##### ## ##### ## # ## ### # # ## #### ## ##### ##### ## #### #####
# # # # #+ ## #### ## # # # #### ### ## # ####### ##### ### ## ### ## # #### ##### # # # # # ### # # ## #
# # ## # ### ####+++## ## # ## ## # ### ### # # # # # # # ## # # ### ## # # # # # ## ### #
# # #### +# ### ## ## ## ## # #### #### # # #### # # # ## # ### ####### # ## ###### ## #### ## ## ## # # #
#### #### #######+#### ## # # # ## ### ##### # ## ### ######### # # # ### # # #### # # ###### # # #
# ## ## # ###+ # ### ## #### # ## # #### ## # # # # #### ## # # # ## ##### ## ## ####### ## ## # # ##### # #
# ## #### ### +## # # ### ## ## #### ### #### ## ## # ## # ### # ## # ## ## ## # # #### #
# ## ### ###+ # # ## ############ # ## ## ## # ### # # ## ### # ##### #### ## # ## ## ## ## # ##### ## ###
# # ## ### ###+## # ## # # # # ### ## ## #### ## ### ###### ## ## #### ### #### ## #### # # #### ## # # # ### #
# # ########### ++# ## #### # # ## # #### ## ## # # # ## ##### # # # # # # ## ## # ## ### ### ##### # # #
# # # ## ######++ ### # # # ## ## ### # # #### ### # ## # # ## ## ## ## # # ## # ## # # ## # ## ### # # # ###### ##
# #### #####+## ## ## # # # # ### ## # # ## # #### ## # # # ## # # ## # # ## ### # ## ## ### ## #
# ## ###### ### +++ ## ## # ## ## ## ## # # # ## ## ##### # ## ####### ## ###### # ## ## # # ###
# # ### #######+### # # # # ## ### ## # ## ### ######## ## # ## ## # # # ## ## ## ########## #######
## # # # #### +## ## # #### ### ## ## ### #### ## ## ##### ### # ## ## # ## # ## #### ## # ## ## #
## ###### #### ###++## #### # ## ### # ## # ## # #### ### ## ##### # ###### ## ## ## ### ## ## ### ###### #
# # ## ###########+# # # # ## #### # ## ### #### ### # ##### # # # # # # ### # ## ## #### # # ##### ## #
## #### ## # # ## +++## ## # ## ### # #### # # # # #### # ## ## ## ##### # # ## # # ## # ## # # ##
### ## # # # ### ###+## ## # ## ## # # # ##### # # ## ## # ### ## # #### # ##### # ### # # # # ### #
# ## #### # ### #+## ##### ### ## # ###### # # ## # # # ### #### ## # # ### # ## ##### ## # # # ### #### # ##
### ## ### #### ## +++ # ## # # # ## # ### ##### ## # # ### ## ## #### # # ## #### ########### ## # # ##
# ## ## # #### ##+### # # # ## # ## ## ## ## ## ## # #### # ## ## ## # # ## # # ### ###### ## # #
#### ##### ## # ### #####+++++++## # # ## ### ## ## ## ## ## ## # # # ########## ## ## # # #### # # # # # ##### ## ##
## ## #### # # # # # #######+ ## ### # #### ## ##### # ## ## ## ##### ## ## ### ## # ## ### # # # ## #
# # ### # # ### ## #+## ## ## # # # ## ## # ## ## ## ######## # ####### ## # # ###### # # # # # ##
# ### # ### ### ### #### #+ # ######### ## # # # # ## #### # ## # ## # # ### ## ## # # ## # ## # # ### ## #
#### # # ###### # # ## # +## ## # ## ## ##### # ### ## ## # ## ### # ## # # #### ###### # # # # ## ## ##
## ## # # ## ### ### # ## ####+ # # ##### ## ## ## ## ### ###### # # # # ## ## ### # ## # # ### #
# # # #### ## # ++## #### # # ## ### # # ## #### ## # ## # # # # ###### ## ## # ###### ### ####
### # # ## ### ### ##### ##+## # # ## ### ## ## ####### #### ##### # ####### # # ###### ## # # ## # #### # ####
### #### ####### # # ### + ## # ## # # # ### # ## ## #### # # ## # # # ### #### ######## # # # #
# ## # ## ## ######+## ## # # #### # # # ### ## ## # # #### # ####### # # ## ## ### ### ## # # # # #
### ## # ######## #### # # ++++###### # # # # # # ## # ###### #### # # ### ## # ###### ## ## # # # # # # #####
## #### ### # ## # # # # #+# ## # # #### # ## ## # ## ######## ## ## # # # # ###### ## ##
# # ## # ###### # ## #####+ ## ## # #### ############ #### # ### # # # # # ######## ## ## ## ### # #### #
##### ## ## ## # ## ### ## ##+##### # ###### ## # ### ## # ## # ## ## ### # # # ## # # ## ### # ### # ### ##
# # ## ## ## ### ## +# ## ## ## ####### # ## # # ##### # # ## # # # # ## ## ### ## # ## ##
# ## #### ## ## ## ######## # ##+++## ## ####### ## ### ## # ## ## # # ## ## ## ###### # # ## ### ## # ## ## #
# # # # ## #### ## ## ######+# ## # # # ### # # #### # ## # #### ## # ### # # ########### ## ### ## # ###
### # # ### # # #### ####### ##+### ## # ### # #### ### #### ## ## # # # ## ## # # ## # ## ## ## #
######### # # # ## ## #### ##+## ## # ###### # ## # ##### ## # ## ## # ### # ## ##### ## ### #### #####
# # ## # ### # # ## ## ## ### # ++## # # ## ## ##### # ## # ## ## # # # # ### # ## #### # # # # # #### # # #
## # ## # # #### # ## # ###++# ## ## ### ## # # ## # ##### ## # ###### # # # ## # ## ## # # # ## ## # ###
####### # ### ## ## # ### ### ##+# ## ###### ## ##### ### ### ### # ## #### ## # # ## # # # #
# # ## # # # # #### # ## ## ## + ### ## # #### ## ### ## ## ## #### ## ### # # #### #### # #### ########
# ## # # # #### ### ###### ## ##+#### ##### ## ## # # # # # # ####### # # # ## # # ## #### # ## # #
### ## ## ## ## # ## ## + # ## ## # ## ## # #### #### # ####### ## #### # ###### ## ## # ## # ##
## ## ###### # ## # # # ## # #####+####### #### # ## ### ## ### ## # ## # ##### # ## # ### ###### # #
# ##### ## # # ### ## #### #### # ## + # ## ## ### # ## ### ### ###### ## ## # ## # ####### # # # # # #####
## # ## ## # ## ## ## ##+### ## ###### # # #### # ## # # # ## ## ## ## ## # # # # ######## # #
# # # ### ## ##### ## ## # #### # +++# # ## # #### ## # #### ## ## # # ## ## ##### ### ## ############ # # # #
## # # ## ## # #### # ### #####+### # # ### ## ## ######## # ##### # # ### ## ## #### # ## # ## # # ## ###
# # ## ##### # ### # # ### # # #+ ## ## # ## ## # # ## ### ###### ## # # ## # ### ## # # ## #
## # # ## ## # # # # # ## # #+## ### ## ###### ####### # ## ### # ### ## #### # # ## ## ## #### # #### ###
# ### # ##### ## # # # ## ### #+ ## ## ## ## # # # ######### #### ### # # ## #### ## ### # ## #
## ## ### # # ## ## # # ## # # +## ## ## ######## ## # ## # # #### ## ## # # ## # #### ##### ###### ###
## #### # ## ## # # #### # ###++++### ## # ##### ## # #### ## ## ## # ## ## # # ## # ########## ## # #
# ## ###### ## # # # # # ####+## ######### ## ### ##### ## ### ### # # # # ######### ### # ## # ###
## # # ## # ####### ## # # # ## # ## ++ ## # ## #### # # #### ### ## ## ## # ##### # ## ######## # ##### ## #
### # # # ###### # ## # ##+#### ## ## ### # # # # ## ## ## ##### # #### # # # # ### ## ## ## #####
# # ### ##### # ## # ## ## ++ ## ### # ## # ####### ## ## ## # # # # # # ## ### # ## #### #### # # #
##### ## ########### # ### ### #+#### # ## ## ### ### # ## # # ### ## # ### #### ## # # # ## # # # # ## #
# # ####### # ## # ## # # # ###+# # # ## ### ### ###### ### # # # ## ### ### ### # ## ### ### ## ### #
# # # #### ## ####### # # #++ # ##### ## # # ### ## # ## ## # # ### ## # # # #### # # # # ## # #
### # #### ###### ## # ### ##+######## # # ## #### ## # #### ## ## # # # #### ## ## # # ## # # ### ### ##### # ##
# #### ## ## ### # # # # ####+ ## # # ## # # # ### ##### # # # ## # # ## # ## ## # # #
# # ## ## ## ##### # # ### # # # #++# # # ## # # ## #### # ### # ## # # #### # ## ## ### # # # ## ###### ### # ##
# ## #### ##### ## ## ++++++++######### # # ## ## # ### # # ## # ## # # ###### # ######### ### ## # # # ##
### ### ## # ####### ### #+## # # # # ## # # # # # # ### ### ### ###### ## ## # # ## ## # ## ### #### #
## # ## # ## # # # # ###+######## #### ### ## ## #### ## # ## ## # # # # ####### # ## # # ## ### # # ### #
# #### # ## # ## # # ## + # ## #### # ### ## # ## # ## ### ### ## ### #### ######## # # ## ## #
# ## #### ## ## ##### ###+### ## ## ## ## #### ## # ## # ### ###### #### ### ## # # ######## ## ##
#### ## # ### # # # ### ++# # ## ##### ############## # # #### ## ## # ### # # ####### ## #### ## #### #
## # ### ## # ## # # ### # ##+## #### ## ## # ## # ## ## ## # ## # ## #### # # # ### ### # # #### ## # ## ### #
# # # ## # # + # ## # # ### #### ### ## ## # ## ####### # # # # ## # ### # # # ####
## # #### ##### ## ## ##+## # #### ## ## ##### # # # # #### ## # ### # ### # ## ###### # ### #### #### # # ### ##
###### ###### ##### # +## ## ## #### ## ### ## ### ## ## # # # # ## # ### # # #### ## ## # # # # ## #
# # # # ######## # ## # #++ # # ## # # ## # ## ## ## # # # ##### # ## # #### ##### ## ## #### ## # # ###
# ## # ### # ####+###### ## # ############ # # # # ## # ### ## #### #### ## # ## ## ## # ##### ## #
#### ###### #### ## # ### + ## # ### ## # ## # ## ## ## ###### # # ### ### ## ### ### ## # #
# # # # # ####### ########+# ## ### ## ## #### ## ## ## ## # # ##### # ## # # # # # # # # ## ## # ## # # ###
# ## # # #### # # # ## # +##### # ### ## # ## #### ## #### # ##### #### #### ### # # ## # # ## # ##########
# # # # ## ### # ## #+ ### ## ## # ## ### # ### ## ## # ##### # # #### ### # ## ## # # # # #
#### #### ## ### # ## ####+#### # ##### ######### ## ######## # # ## #### ## # # ## ### ### ## #### # # # ##
# # ### # ## # #### ## +## ### ## #### # ### ####### #### ## #### # # # # ## # ##### # # #
# # # ### # ## #### ##+## # ### ### # #### # ## ### # # ## ## ## # ## ### # # ###### ## ## # ## # ####
## ##### # #### # ## ++# # ## ## ### ### ## ## ## ## #### ## ## ## ## # # ####### ######## # ## ## # # #
#### # # # # ###### ####+# # ## ### # ## ## ## ### # #### ## ## ## # # # ## # ## # ## # # ### ### ##### #
# # # #### # # ### # # + ## ## #### # ###### # ## # ### # # ### # ## # ## ## # # ## ####### ## #
########### ### ####### # ##+# ## # ########## # # # ## #### # # # ## ##### ####### #### # ## # # # # ## #
# ## ## # ## # ## # +##### ## # # # # # # ## ##### ## ## ### # # # # # # # # # # ## #
# ## ## ## ###### # ## #####+ ## # ######## # # ## ## # ## ##### ## # # # # ### ######## ## ########### ##
# ## ## ## # # # ## ########+# ### # ## ###### ## # ### # ## # ## # ### # # ## ########## ## ## ###
# # ### ## ### # # ## +### # # ## ## ## ## ## #### ###### ### ## ## # ## ## ## ## #### #### ### # # #### #
# ## # ## ## #### # # # ###+ ## ########## # # ##### # # ### ## ### # # ##### # # ## # ## ###### ## ###
### ## #### # ##### +## ## ## # ## ## # ## ### ### ### # #### ## ## ## ## ##### #### ## # # # # ## #
# # ## ##### ### # # # ## ##+ ## # ## # ## # # # # # # # # ####### # ##### # # # # ### ### ### # #######
# ####### ## # # # ## ## # +#### ## # ######## ## ## #### # # # ## # # # # # # ### # # # ##### ##### #
# ## # ## # # # #### ## ##+ ## ### # # ## # # # ## # #### #### ## ### # # ## ### # ### ## # # # ###### #####
## # ## # # # ## # +#### ### # ## # ####### ## ##### # ## ### ## # ### # ### ##### # #
## ##### # ### ## ## ## ##+## ## # ### ### ### # ## ##### # ## # # # # # # ## ##### #### ############
# # # ##### ###### ##### # +++ ## ## ## ### ## # # ########### ### ## ## #### ## ### ## # ## # ## ##
# ## # #### ## # # ## ##+### # ## ## ### ## # # # # ## ## # ## # #### #### ## #### ## ## ###### ## #
# ## ## # ###### ## # #######+### ### # ## ## # ## ## ## # ## # ### ## # ## # #### ##### ####### ### ##
# ## ## ## # # ## # ## ## ## +# # #### ## # # # ########### ### ## #### # ## ## # ## ### ## # #####
# # # ## # ######### ## ###+ # ## ## ## # # ## # ## ## ###### ####### # # ## ## ### ###### ##### # ## # #
## # ## #### ## # # ## #+# #### ## ## ## # # # ##### ### # # # # ## #### # # ### # ## ########
# # ### # ## ###### # # #+##### ### ## # # # ##### # # # ## # # # ###### ##### ### # ### ## # # ## # #
##### ## ### ## ## ### # ## ++## #### # ## ### #### # # # ## ## ## ### ## # ############ #
# # # ## # ## # #### # #####+ # ## # ## # # # ### ################### # # ##### ########### # # ## # ######
# # # ###### ## ## # # +## ### ##### ## ######### # ## ### #### ## # # #### # ## # ## # #### # #
# # ## # # ## # # ##### # ###+ ## ## ########### ### ## # # # # ### # ## # ### ### # ### ## #
# ### ### # ## ###### # #+########## ## ### # # ## ## ####### # ## ###### ##### # ## ## ######## ### ## #
# ## ### ### #### # ###### #+ # ## ### ## # # # ### ## # # ## # ## ##### ###### # # #
#### ##### # # # # # ## +###### ## # # # # ##### ##### #### # ###### # # # #### #### #### # # #########
### ## ### ##### # ## ######+# # ## ## # ######## # # # # # ## ## # # # # # ## ## ### # ### #
# ## ##### # ## # ###### # ## ++++ # ## # #### ## # # # ## ###### # # ## ##### # ########## # ## ### ##
# # ## ### # ## # ######+### ## ####### ## ##### ### ### ## # ## ## ### #### # ########### ## #
#### # ## # ## ### ##### ### # +# # # ##### # # ### ######## # # # # ## ### # # # # # #######
# # ## ### # # # ### # ## ##+# # ## ## ####### ## # ## ### # # # #### # ## ## ####### ## ### ######### #
## ## # ## # ##### ## ## # +# # ## # #### # # ######## ## # # ####### # # # ## # # #### ## ######
# # ### # # ## ### ### ## ###+# #### #### ## # ##### ### # # #### ### ####### ####### ## ## ####### # #
#### # ### # #### # # ## #########+### ## ### #### # #### ## # # # # ## # ## # ############# # #
# ### ### # # # ### # # ## +++++### ### # # # ###### ## ### # # # ## ## # ## ### # ## # ### ### # # ## ##
###### ### ### # ### ## # ## ### ###+# # # # # # ## ## # ## ## ####### ######## ###### #### ### # #
## # ## # # # ### #### ## ## ### #+ # # ### # # ## # ## ########## # ## # #### ## ################ #
# # ## # ### ## #+### # ### ### ### # ## ## # #### #### ## ######### ## # ###
######### ## # ## ################ #### #+ ## ### ###### # ## ###### # ## # ########## #### # # # ####### #
# ## # # # # ## #+#### ##### # # ### ##### # ### ## # ## # ## # # ###### # ######
########### ####### ######### #### ## #+ ## # # # # ### # # # # ## ## ### # # #### ## ##### #
# # # # ## ## # ## # ## ## +###### ## # # # ##### # ### ## # # ######### ## ### ############# # # #
# # ####### ## ##### #### #####+# # ##### ### ########### ### # # ######## ## ## ## # ## # ## ## ######## #
##### # ## # ###### # # # # #+# # # # # #### # # # # ####### ## ## ##### ### ###### # #
# ###### ## ###### ++ ### # # # #+++++++++## #### #### ## # #### ### ## # ## ###### # ##++++++#### ## # #
### ### ## ### # ##### ########## ####+#### # # ##+#######++ # # ######### # # #########++## #+++##### # #
###### ##### # # ### +#### ### # ###++ # ##+++#### #### ## # ### # # #### ## ##+++##### #+ # # #
# # # # # #### # ### ## # # ## ##+++ # ##++++++++# ##### #++# # ## ## +++#####+++++ ############++# # #+##### # #
## # # # # # # # ######## # # # ### # #+##++++######## # ####++++ ## ###++++#+++++++###+## # # # #+++#### ### #+ ######
#### ####### # #### # ######## ## #++++# ## ### ### ### #+## #+ ++# ## # # # #+ ##+++++# ########+## #####
# ####### # ### ###### # # ##### # # # ########## ### # #++++++# ## ### # ## ##+#######+######### # #+##### # #
# ### # ## #### ######## # ### # ###### # ### # ########## # #### #++++++++++ # ##++++++ #
## # ## # ##### ## ### ##### #### # # ## # ## # # ### ## # ## ### # # # ## ## # ## ##### # #### #+#####
# # # # ## ## # ## # # ## ## # # # # # ## ## # # # ## # ## # # # # # # # # # # #+++++ #
################################################### ################################################### ########################### #